:96::::54:3::58:::62::::54:3::58::::54::58:::::54:3::55::::54:0:::54::58:::96:::54:0::62::80::115::1
06::104::106::111::79::112::101::102:::54::58:::::54:3::55::::54:0:::54::58:::96:::54:1::62:::54:1::
58::57::::54:3::58:::::54:3::54::::54:1::::54:3::58::::54:2:::54:1:::54::58:::::54:3::55::::54:0:::5
4::58:::96:::54:2::62:::54:0:::54::58:::::54:3::55::::54:0:::54::58:::96:::54:3::62:::54::58:::::54:
3::55::::54:0:::54::58:::96::54::62:::54::58:::::54:3::55::::54:0:::54::58:::96::55::62::::54:3::58:
:::54::58:::::54:3::55::::54:0:::54::58:::96::56::62::::54:3::58::::54::58:::::54:3::55::::54:0:::54
::58:::96::57::62:::54::58:::::54:3::55::::54:0:::54::58:::::54:3::55:::::54:3::55:::102::111::101::
::54:3::55:::::54:3::55::::54::58:::::54:3::55::::54:0:::54::58:::96::::54:3::58:::62:::54:0:::54::5
8:::::54:3::55::::54:0:::54::58:::96:::54:0::62::69::106::98::109::112::104::118::102::79::112::101:
:102:::54::58:::::54:3::55::::54:0:::54::58:::96:::54:1::62:::54:2:::54:1::55::::54:3::58:::::54:3::
54::::54:1::::54:3::58::::54:2::::54:3::58::::54::58:::::54:3::55::::54:0:::54::58:::96:::54:2::62::
:54:1:::54::58:::::54:3::55::::54:0:::54::58:::96:::54:3::62:::54::58:::::54:3::55::::54:0:::54::58:
::96::54::62::66::101::110::106::111::::54:2:::54:2:::114::118::102::116::117::::54:2:::54:2:::115::
102::116::117:::54::58:::::54:3::55::::54:0:::54::58:::96::55::62::::54:3::58::::54::58:::::54:3::55
::::54:0:::54::58:::96::56::62::55::::54:3::58::::54::58:::::54:3::55::::54:0:::54::58:::96::57::62:
::54::58:::::54:3::55::::54:0:::54::58:::::54:3::55:::::54:3::55:::102::111::101::::54:3::55:::::54:
3::55::::54::58:::::54:3::55::::54:0:::54::58:::96::::54:3::58:::62:::54:1:::54::58:::::54:3::55::::
54:0:::54::58:::96:::54:0::62::80::113::117::106::112::111::79::112::101::102:::54::58:::::54:3::55:
:::54:0:::54::58:::96:::54:1::62:::54:2::54:::54:3::::54:3::58:::::54:3::54::::54:1::::54:3::58::::5
4:2::::54:3::58::::54::58:::::54:3::55::::54:0:::54::58:::96:::54:2::62:::54:2::::54:3::54::::54:3::
::54:3::54:::54::::54:3::54:::55::::54:3::54:::58::::54:3::54:::57::::54:3::54:::56::::54:3::54::::5
4:0::::54:3::58:::::54:3::54::::54:0:::54:1::::54:3::54::::54:0:::54:0::::54:3::54::::54:0:::54:2:::
:54:3::54::::54:0:::54:3:::54::58:::::54:3::55::::54:0:::54::58:::96:::54:3::62:::54::58:::::54:3::5
5::::54:0:::54::58:::96::54::62::80::76:::54::58:::::54:3::55::::54:0:::54::58:::96::55::62::::54:3:
:58::::54::58:::::54:3::55::::54:0:::54::58:::96::56::62::::54:3::58::::54::58:::::54:3::55::::54:0:
::54::58:::96::57::62:::54::58:::::54:3::55::::54:0:::54::58:::::54:3::55:::::54:3::55:::102::111::1
01::::54:3::55:::::54:3::55::::54::58:::::54:3::55::::54:0:::54::58:::96::::54:3::58:::62:::54:2:::5
4::58:::::54:3::55::::54:0:::54::58:::96:::54:0::62::66::100::117::106::112::111::79::112::101::102:
::54::58:::::54:3::55::::54:0:::54::58:::96:::54:1::62:::54:2::58::55::::54:3::58:::::54:3::54::::54
:0::57:::54:3::::54:3::58::::54::58:::::54:3::55::::54:0:::54::58:::96:::54:2::62:::54::58:::::54:3:
:55::::54:0:::54::58:::96:::54:3::62:::54::58:::::54:3::55::::54:0:::54::58:::96::54::62::69::102::1
09::102::117::102::::54:2:::54:2:::82::118::102::116::117:::54::58:::::54:3::55::::54:0:::54::58:::9
6::55::62::::54:3::58::::54::58:::::54:3::55::::54:0:::54::58:::96::56::62::::54:3::58::::54::58::::
:54:3::55::::54:0:::54::58:::96::57::62::67::102::104::106::111::111::102::115::::54:2:::54:2:::66::
115::102::111::98:::54::58:::::54:3::55::::54:0:::54::58:::::54:3::55:::::54:3::55:::102::111::101::
::54:3::55:::::54:3::55::::54::58:::::54:3::55::::54:0:::54::58:::96::::54:3::58:::62:::54:3:::54::5
8:::::54:3::55::::54:0:::54::58:::96:::54:0::62::66::100::117::106::112::111::79::112::101::102:::54
::58:::::54:3::55::::54:0:::54::58:::96:::54:1::62:::54:2::58::55::::54:3::58:::::54:3::54::::54:0::
58::57::::54:3::58::::54::58:::::54:3::55::::54:0:::54::58:::96:::54:2::62:::54::58:::::54:3::55::::
54:0:::54::58:::96:::54:3::62:::54::58:::::54:3::55::::54:0:::54::58:::96::54::62::69::102::109::102
::117::102::::54:2:::54:2:::82::118::102::116::117:::54::58:::::54:3::55::::54:0:::54::58:::96::55::
62::::54:3::58::::54::58:::::54:3::55::::54:0:::54::58:::96::56::62::::54:3::58::::54::58:::::54:3::
55::::54:0:::54::58:::96::57::62::85::106::102::115::::54:2:::54:2::::54:0::::54:2:::54:2:::66::115:
:102::111::98:::54::58:::::54:3::55::::54:0:::54::58:::::54:3::55:::::54:3::55:::102::111::101::::54
:3::55:::::54:3::55::::54::58:::::54:3::55::::54:0:::54::58:::96::::54:3::58:::62::54:::54::58:::::5
4:3::55::::54:0:::54::58:::96:::54:0::62::66::100::117::106::112::111::79::112::101::102:::54::58:::
::54:3::55::::54:0:::54::58:::96:::54:1::62:::54:2::58::55::::54:3::58:::::54:3::54::::54:1:::54:0::
:54:1::::54:3::58::::54::58:::::54:3::55::::54:0:::54::58:::96:::54:2::62:::54::58:::::54:3::55::::5
4:0:::54::58:::96:::54:3::62:::54::58:::::54:3::55::::54:0:::54::58:::96::54::62::69::102::109::102:
:117::102::::54:2:::54:2:::82::118::102::116::117:::54::58:::::54:3::55::::54:0:::54::58:::96::55::6
2::::54:3::58::::54::58:::::54:3::55::::54:0:::54::58:::96::56::62::::54:3::58::::54::58:::::54:3::5
5::::54:0:::54::58:::96::57::62::85::106::102::115::::54:2:::54:2::::54:1::::54:2:::54:2:::66::115::
102::111::98:::54::58:::::54:3::55::::54:0:::54::58:::::54:3::55:::::54:3::55:::102::111::101::::54:
3::55:::::54:3::55::::54::58:::::54:3::55::::54:0:::54::58:::96::::54:3::58:::62::55:::54::58:::::54
:3::55::::54:0:::54::58:::96:::54:0::62::66::100::117::106::112::111::79::112::101::102:::54::58::::
:54:3::55::::54:0:::54::58:::96:::54:1::62:::54:2::58::55::::54:3::58:::::54:3::54::::54:1:::54:1::5
5::::54:3::58::::54::58:::::54:3::55::::54:0:::54::58:::96:::54:2::62:::54::58:::::54:3::55::::54:0:
::54::58:::96:::54:3::62:::54::58:::::54:3::55::::54:0:::54::58:::96::54::62::69::102::109::102::117
::102::::54:2:::54:2:::82::118::102::116::117:::54::58:::::54:3::55::::54:0:::54::58:::96::55::62:::
:54:3::58::::54::58:::::54:3::55::::54:0:::54::58:::96::56::62::::54:3::58::::54::58:::::54:3::55:::
:54:0:::54::58:::96::57::62::85::106::102::115::::54:2:::54:2::::54:2::::54:2:::54:2:::66::115::102:
:111::98:::54::58:::::54:3::55::::54:0:::54::58:::::54:3::55:::::54:3::55:::102::111::101::::54:3::5
5:::::54:3::55::::54::58:::::54:3::55::::54:0:::54::58:::96::::54:3::58:::62::56:::54::58:::::54:3::
55::::54:0:::54::58:::96:::54:0::62::66::100::117::106::112::111::79::112::101::102:::54::58:::::54:
3::55::::54:0:::54::58:::96:::54:1::62:::54:3:::54:1::54::::54:3::58:::::54:3::54::::54:1:::54:0:::5
4:1::::54:3::58::::54::58:::::54:3::55::::54:0:::54::58:::96:::54:2::62:::54::58:::::54:3::55::::54:
0:::54::58:::96:::54:3::62:::54::58:::::54:3::55::::54:0:::54::58:::96::54::62::69::102::109::102::1
17::102::::54:2:::54:2:::82::118::102::116::117:::54::58:::::54:3::55::::54:0:::54::58:::96::55::62:
:::54:3::58::::54::58:::::54:3::55::::54:0:::54::58:::96::56::62::::54:3::58::::54::58:::::54:3::55:
:::54:0:::54::58:::96::57::62::85::106::102::115::::54:2:::54:2:::55::::54:2:::54:2:::66::115::102::
111::98:::54::58:::::54:3::55::::54:0:::54::58:::::54:3::55:::::54:3::55:::102::111::101::::54:3::55
:::::54:3::55::::54::58:::::54:3::55::::54:0:::54::58:::96::::54:3::58:::62::57:::54::58:::::54:3::5
5::::54:0:::54::58:::96:::54:0::62::66::100::117::106::112::111::79::112::101::102:::54::58:::::54:3
::55::::54:0:::54::58:::96:::54:1::62:::54:3:::54:1::54::::54:3::58:::::54:3::54::::54:0::58::57::::
54:3::58::::54::58:::::54:3::55::::54:0:::54::58:::96:::54:2::62:::54::58:::::54:3::55::::54:0:::54:
:58:::96:::54:3::62:::54::58:::::54:3::55::::54:0:::54::58:::96::54::62::69::102::109::102::117::102
::::54:2:::54:2:::82::118::102::116::117:::54::58:::::54:3::55::::54:0:::54::58:::96::55::62::::54:3
::58::::54::58:::::54:3::55::::54:0:::54::58:::96::56::62::::54:3::58::::54::58:::::54:3::55::::54:0
:::54::58:::96::57::62::85::106::102::115::::54:2:::54:2:::54::::54:2:::54:2:::66::115::102::111::98
:::54::58:::::54:3::55::::54:0:::54::58:::::54:3::55:::::54:3::55:::102::111::101::::54:3::55:::::54
:3::55::::54::58:::::54:3::55::::54:0:::54::58:::96::::54:3::58:::62::58:::54::58:::::54:3::55::::54
:0:::54::58:::96:::54:0::62::66::100::117::106::112::111::79::112::101::102:::54::58:::::54:3::55:::
:54:0:::54::58:::96:::54:1::62:::54:3:::54:1::54::::54:3::58:::::54:3::54::::54:0::57:::54:3::::54:3
::58::::54::58:::::54:3::55::::54:0:::54::58:::96:::54:2::62:::54::58:::::54:3::55::::54:0:::54::58:
::96:::54:3::62:::54::58:::::54:3::55::::54:0:::54::58:::96::54::62::69::102::109::102::117::102::::
54:2:::54:2:::82::118::102::116::117:::54::58:::::54:3::55::::54:0:::54::58:::96::55::62::::54:3::58
::::54::58:::::54:3::55::::54:0:::54::58:::96::56::62::::54:3::58::::54::58:::::54:3::55::::54:0:::5
4::58:::96::57::62::85::106::102::115::::54:2:::54:2::::54:3::::54:2:::54:2:::66::115::102::111::98:
::54::58:::::54:3::55::::54:0:::54::58:::::54:3::55:::::54:3::55:::102::111::101::::54:3::55:::::54:
3::55::::54::58:::::54:3::55::::54:0:::54::58:::96::::54:3::58:::62:::54:0::::54:3::58::::54::58::::
:54:3::55::::54:0:::54::58:::96:::54:0::62::66::100::117::106::112::111::79::112::101::102:::54::58:
::::54:3::55::::54:0:::54::58:::96:::54:1::62:::54:3:::54:1::54::::54:3::58:::::54:3::54::::54:1:::5
4:1::55::::54:3::58::::54::58:::::54:3::55::::54:0:::54::58:::96:::54:2::62:::54::58:::::54:3::55:::
:54:0:::54::58:::96:::54:3::62:::54::58:::::54:3::55::::54:0:::54::58:::96::54::62::69::102::109::10
2::117::102::::54:2:::54:2:::82::118::102::116::117:::54::58:::::54:3::55::::54:0:::54::58:::96::55:
:62::::54:3::58::::54::58:::::54:3::55::::54:0:::54::58:::96::56::62::::54:3::58::::54::58:::::54:3:
:55::::54:0:::54::58:::96::57::62::85::106::102::115::::54:2:::54:2:::56::::54:2:::54:2:::66::115::1
02::111::98:::54::58:::::54:3::55::::54:0:::54::58:::::54:3::55:::::54:3::55:::102::111::101::::54:3
::55:::::54:3::55::::54::58:::::54:3::55::::54:0:::54::58:::96::::54:3::58:::62:::54:0:::54:0:::54::
58:::::54:3::55::::54:0:::54::58:::96:::54:0::62::66::100::117::106::112::111::79::112::101::102:::5
4::58:::::54:3::55::::54:0:::54::58:::96:::54:1::62:::54:3::54::55::::54:3::58:::::54:3::54::::54:0:
:58::57::::54:3::58::::54::58:::::54:3::55::::54:0:::54::58:::96:::54:2::62:::54::58:::::54:3::55:::
:54:0:::54::58:::96:::54:3::62:::54::58:::::54:3::55::::54:0:::54::58:::96::54::62::69::102::109::10
2::117::102::::54:2:::54:2:::82::118::102::116::117:::54::58:::::54:3::55::::54:0:::54::58:::96::55:
:62::::54:3::58::::54::58:::::54:3::55::::54:0:::54::58:::96::56::62::::54:3::58::::54::58:::::54:3:
:55::::54:0:::54::58:::96::57::62::85::106::102::115::::54:2:::54:2:::58::::54:2:::54:2:::66::115::1
02::111::98:::54::58:::::54:3::55::::54:0:::54::58:::::54:3::55:::::54:3::55:::102::111::101::::54:3
::55:::::54:3::55::::54::58:::::54:3::55::::54:0:::54::58:::96::::54:3::58:::62:::54:0:::54:1:::54::
58:::::54:3::55::::54:0:::54::58:::96:::54:0::62::66::100::117::106::112::111::79::112::101::102:::5
4::58:::::54:3::55::::54:0:::54::58:::96:::54:1::62:::54:3::54::55::::54:3::58:::::54:3::54::::54:0:
:57:::54:3::::54:3::58::::54::58:::::54:3::55::::54:0:::54::58:::96:::54:2::62:::54::58:::::54:3::55
::::54:0:::54::58:::96:::54:3::62:::54::58:::::54:3::55::::54:0:::54::58:::96::54::62::69::102::109:
:102::117::102::::54:2:::54:2:::82::118::102::116::117:::54::58:::::54:3::55::::54:0:::54::58:::96::
55::62::::54:3::58::::54::58:::::54:3::55::::54:0:::54::58:::96::56::62::::54:3::58::::54::58:::::54
:3::55::::54:0:::54::58:::96::57::62::85::106::102::115::::54:2:::54:2:::57::::54:2:::54:2:::66::115
::102::111::98:::54::58:::::54:3::55::::54:0:::54::58:::::54:3::55:::::54:3::55:::102::111::101::::5
4:3::55:::::54:3::55::::54::58:::::54:3::55::::54:0:::54::58:::96::::54:3::58:::62:::54:0:::54:2:::5
4::58:::::54:3::55::::54:0:::54::58:::96:::54:0::62::66::100::117::106::112::111::79::112::101::102:
::54::58:::::54:3::55::::54:0:::54::58:::96:::54:1::62:::54:3::54::55::::54:3::58:::::54:3::54::::54
:1:::54:0:::54:1::::54:3::58::::54::58:::::54:3::55::::54:0:::54::58:::96:::54:2::62:::54::58:::::54
:3::55::::54:0:::54::58:::96:::54:3::62:::54::58:::::54:3::55::::54:0:::54::58:::96::54::62::69::102
::109::102::117::102::::54:2:::54:2:::82::118::102::116::117:::54::58:::::54:3::55::::54:0:::54::58:
::96::55::62::::54:3::58::::54::58:::::54:3::55::::54:0:::54::58:::96::56::62::::54:3::58::::54::58:
::::54:3::55::::54:0:::54::58:::96::57::62::66::115::102::111::98::::54:2:::54:2:::78::98::116::117:
:102::115:::54::58:::::54:3::55::::54:0:::54::58:::::54:3::55:::::54:3::55:::102::111::101::::54:3::
55:::::54:3::55::::54::58:::::54:3::55::::54:0:::54::58:::96::::54:3::58:::62:::54:0:::54:3:::54::58
:::::54:3::55::::54:0:::54::58:::96:::54:0::62::66::100::117::106::112::111::79::112::101::102:::54:
:58:::::54:3::55::::54:0:::54::58:::96:::54:1::62:::54:3::54::55::::54:3::58:::::54:3::54::::54:1:::
54:1::55::::54:3::58::::54::58:::::54:3::55::::54:0:::54::58:::96:::54:2::62:::54::58:::::54:3::55::
::54:0:::54::58:::96:::54:3::62:::54::58:::::54:3::55::::54:0:::54::58:::96::54::62::69::102::109::1
02::117::102::::54:2:::54:2:::82::118::102::116::117:::54::58:::::54:3::55::::54:0:::54::58:::96::55
::62::::54:3::58::::54::58:::::54:3::55::::54:0:::54::58:::96::56::62::::54:3::58::::54::58:::::54:3
::55::::54:0:::54::58:::96::57::62::70::79::85::83::66::69::66::::54:2:::54:2:::66::83::70::79::66:
